3333333333333
3000000300003
3040000300003
3000000000003
3000300020333
3033000330003
3000000000003
3000313330003
3000003000003
3333333333333